1111111111111
1PC10G0000001
10000G01000E1
10000G01C0001
1111111111111
1101101000111
1101101111011
1110001000011
1111101011111
1111101100011
1111111111111
