111111111111111111111111111111111111111111111111111111111111
100010100000001010100010C01010101010101000100010000000000001
100010000010001000000010001000000000101000100010100000000001
100010001010001010101000001000101000000000101010100000000001
10001000100G000000100010101010100010101000101000100000000001
10G0100010001010P0100010000000100G10001000000000100000000001
100010000000001000100000001000100010000000101010100000000001
100010101010001010101010101000101010001010100000000000000001
10000000000G001000000000001000000010000000100010000000000001
101010101010001010100010101010100010001010100010000000000001
10000000001000000010001000000010001000100E000010000000000001
100010100010G01010100C10101000100010001000101010000000000001
100010100010G0101010001010100010001000100010101000000000G001
100010100010G01010100010101000100010001000101010000000000001
100010100010G01010100010101000100010001000101010000C00000001
100010100010G010101000101010001000100010C0101010000000000001
100010100010G01010100010101000100010001000101010000000000001
100010100010G010101000101010001000100010001010100000000C0001
100010100010G01010100010101000100010001000101010000000000001
100010100010G0101010001010100010001000100010101000C000000001
100010100010G01010100010101000100010001000101010000000000001
100010100010G01010100010101000100010001000101010000000C00001
100010100010G01010100010101000100010001000101010000000000001
100010100010G01010100010101000100010001000101010000000000001
100010100010G01010100010101000100010001000101010000000000001
100010100010G010101000101010001000100010C0101010000000000001
100010100010G01010100010101000100010001000101010000000000001
100010100010G01010100010101000100010001000101010000000000001
100010100010G01010100010101000100010001000101010000000000001
111111111111111111111111111111111111111111111111111111111111
