1111111111111111111111111111111111
1E00000000C00000C000000C0000000001
1110010100100G0010100100000G010101
101001001001010001001000C000010101
1P0000001C10C00000G00000G0000001C1
1111111111111111111111111111111111
