1111111111111111111111111111111111
1E00000000C00000C00000000000000001
1110010100100000101001000000010101
1010010010010100010010000000101001
1P0000001C10C0000000000000000001C1
1111111111111111111111111111111111
